{
    "tileset": "test.png",
    "layer_1": [
        [0, 0, 0, 0, 0, 0, 0, 0, 0, 0],
        [0, 0, 0, 0, 0, 0, 0, 0, 0, 0],
        [0, 0, 0, 0, 0, 0, 0, 0, 0, 0],
        [0, 0, 0, 0, 2, 0, 0, 0, 0, 0],
        [0, 0, 0, 0, 0, 0, 0, 0, 0, 0],
        [0, 0, 0, 0, 2, 0, 0, 0, 0, 0],
        [0, 0, 0, 0, 0, 0, 0, 0, 0, 0],
        [0, 0, 0, 0, 0, 0, 0, 0, 0, 0],
        [0, 0, 0, 0, 0, 0, 0, 0, 0, 0],
        [0, 0, 0, 0, 0, 0, 0, 0, 0, 0]
    ],
    "collision": [
        [99, 99, 99, 99, 99, 99, 99, 99, 99, 99],
        [99, 99, 99, 99, 99, 99, 99, 99, 99, 99],
        [99, 99, 99, 99, 99, 99, 99, 99, 99, 99],
        [99, 99, 99, 99, -1, 99, 99, 99, 99, 99],
        [99, 99, 99, 99, 99, 99, 99, 99, 99, 99],
        [99, 99, 99, 99, -1, 99, 99, 99, 99, 99],
        [99, 99, 99, 99, 99, 99, 99, 99, 99, 99],
        [99, 99, 99, 99, 99, 99, 99, 99, 99, 99],
        [99, 99, 99, 99, 99, 99, 99, 99, 99, 99],
        [99, 99, 99, 99, 99, 99, 99, 99, 99, 99]
    ]
    
}