{
    "tileset": "test.png",
    "grid": [
        [0, 0, 0, 0, 0, 0, 0, 0, 0, 0],
        [0, 0, 0, 3, 3, 3, 0, 0, 0, 0],
        [0, 0, 0, 3, 3, 3, 0, 0, 0, 0],
        [0, 0, 0, 3, 3, 3, 0, 0, 0, 0],
        [0, 0, 0, 0, 0, 0, 0, 0, 0, 0],
        [0, 0, 0, 3, 3, 3, 0, 0, 0, 0],
        [0, 0, 0, 3, 3, 3, 0, 0, 0, 0],
        [0, 0, 0, 3, 3, 3, 0, 0, 0, 0],
        [0, 0, 0, 3, 3, 3, 0, 0, 0, 0],
        [0, 0, 0, 0, 0, 0, 0, 0, 0, 0]
    ],
    "layer_1": [[]],
    "layer_2": [[]],
    "layer_3": [[]],
    "layer_4": [[]],
    "events": [[]]
}